10.ox
.oo...o.o.
o.oo.o...o
oooooooooo
..oo.o..o.
..ooo..ooo
oo.o.o....
....ooooo.
.o..o...oo
ooo.....o.
o.oo.....o
